R 1001 630

NO ./Textures/north.xpm
WE ./Textures/west.xpm
SO ./Textures/south.xpm
EA ./Textures/east.xpm
S ./Textures/sprite.xpm

F 232, 185, 100
C 185, 56, 3

111111111111111111111111111111111111111111111111111111111111111111111111111111111111111111
11W222222222222222222222222222220000000000000002222200000000202221
111111111111111111111111111111111111111111111111111111111111111111111111111