R 1960 1040
NO ../gf/Textures/north.xpm
WE ../gf/Textures/west.xpm
SO ../gf/Textures/south.xpm
EA ../gf/Textures/east.xpm
S ../gf/Textures/sprite.xpm
F 50,100,20
C 255,30,0

        1111111111111111111111111
        1222222222222222222222221
        1000000000000000000000001
        1000000000000000000000001
        1000000000000000000000001
        100000000000000000000000111111
        100000000100000000000000120011
        100000001000000000000000010001
        100000000000000000000000111111
        1000000000000000000000001
        1000000000000000000000001
        1000000000000000000000001
        1000000000000000000000001
        1000000000002000000000001
        1000000000000N00000000001
        1111111111111111111111111